# # # # # # # # # # # #
# # # - - - # # # # # #
# # - - # - # - # - # #
# # - # # - - - - - C #
# E - P # # # G # - # #
# # - # # T T # # # # #
# - - - # T # # # - # #
# # - # # - # - - - # #
# # - - - - # - # # P #
# # - # # # - - # G - #
# # - - - - - # T - T #
# # # # # # # # # # # #