# # # # # # # # # # #
# # # # # # # - - - #
# # P - - - - - # - #
# E # # # - # - T - #
# D # G K - # # # # #
# - T # # # P - - C #
# - # # # # # # # - #
# - # T - - - # - - #
# - # T # # - # G # #
# - # T # # - # - # #
# - # # - - - - - # #
# - - - - # # # # # #
# # # # # # # # # # #