# # # # # # # # # # #
# # # # # # # T # # #
# T T G # G - - - K #
# # P # # P # - # K #
# # # # # # - - - # #
# E D - T - D # - - #
# # # # # # # # # - #
# # - - - - - # - - #
# # - # # # - # - # #
# # - - - # - - - # #
# # # - # # # T # # #
# # C - # # # # # # #
# # # # # # # # # # #