# # # # # # # # # # # #
# # E # # # # # # # # #
# # - # # # # - - - # #
# # - - - - # - # G P #
# # # # # - # - - # # #
# # # - # - D # - T # #
# # # # # # - # # - # #
# # - - - - - # - - # #
# K - # # # - # - # # #
# # # - - - - - - # T #
# # # - # # # # # # T #
# # # C # P T T G T T #
# # # # # # # # # # # #